11111111
10000001
1CDEP001
11111111
